ADNP	ADNP	activity-dependent neuroprotector	N/A
AHR	AHR	aryl hydrocarbon;aryl hydrocarbon receptor	N/A
AKAP9	AKAP9	kinase anchor protein 9;A-kinase anchor protein 9	N/A
AMEL	AMEL	amelogenin	N/A
BACH1	BACH1	basic leucine zipper transcription factor 1;BTB and CNC homology 1;BTB and CNC-like 1	N/A
BACH2	BACH2	BTB and CNC-like protein 2	N/A
BDNF	BDNF	brain-derived neurotrophic factor;brain derived neurotrophic factor	N/A
BHLHB2	BHLHB2	basic helix-loop-helix domain-containing protein class B2	N/A
BMP2	BMP2	bone morphogenetic protein 2	N/A
CAND1	CAND1	cullin-associated and neddylation-dissociated protein 1	N/A
CARD4	CARD4	caspase recruitment domain family member 4	N/A
CILP	CILP	cartilage intermediate layer protein	N/A
CMOS	CMOS;C-MOS	oocyte maturation factor	N/A
CXCR4	CXCR4	chemokine C-X-C motif receptor 4;C-X-C chemokine receptor type 4	N/A
DLL1	DLL1;DLL	distal-less	N/A
DNAH3	DNAH3	dynein axonemal heavy chain 3;dynein axonemal heavy chain 3s	N/A
ECEL1	ECEL1;ECEL	endothelin converting;endothelin converting enzyme-like 1	N/A
ENC1	ENC1	ectodermal neural cortex 1	N/A
EXPH5	EXPH5	exophilin;exophilin 5;exophilin-5;exophilin protein 5	N/A
FSHR	FSHR	follicle stimulating hormone;follicle-stimulating hormone receptor	N/A
FSTL5	FSTL5	follistatin-like protein 5;follistatin-like 5	N/A
GALR1	GALR1	galanin receptor 1	N/A
GHSR	GHSR	growth hormone secretagogue	N/A
GPR37	GPR37	G protein-coupled receptor 37;receptor 37	N/A
HLCS	HLCS	holocarboxylase synthetase	N/A
INHIBA	INHIBA;INHBA	inhibin beta A	N/A
KIAA1217	KIAA1217	sickle tail protein	N/A
KIAA1549	KIAA1549	KIAA1549	N/A
KIAA2018	KIAA2018	KIAA2018	N/A
KIF24	KIF24	kinesin family member 24	N/A
LRRN1	LRRN1	leucine rich repeat neuronal 1;leucine-rich repeat neuronal 1	N/A
LZTS1	LZTS1	leucine zipper tumor suppressor	N/A
MC1R	MC1R	melanocortin receptor 1;melanocortin 1 receptor	N/A
MKL1	MKL1	megakaryoblastic leukemia;leukemia translocation 1;leukemia 1 protein	N/A
MLL3	MLL3	leukemia 3;myeloid/lymphoid;mixed-lineage leukemia 3	N/A
MSH6	MSH6	mutS protein 6	N/A
MXRA5	MXRA5	matrix-remodelling associated 5;matrix-remodelling associated protein 5	N/A
MYH2	MYH2	myosin heavy chain	N/A
NGFB	NGFB	nerve growth factor beta;growth factor beta polypeptide;nerve growth-factor beta	N/A
NKTR	NKTR	natural killer-tumor;NK-tumor recognition protein	N/A
NOS1	NOS1	nitric oxide synthase 1	N/A
NT3	NT3	neurotrophin 3;neurotrophin-3	N/A
PDC	PDC	phosducin	N/A
PNN	PNN	pinin;pinin desmosome associated protein	N/A
PRLR	PRLR	prolactin receptor;prolactin	N/A
PTGER4	PTGER4	prostaglandin E receptor 4;receptor 4 subtype EP4	N/A
PTPN	PTPN;PTPN12	protein tyrosine phosphatase;tyrosine phosphatase non-receptor type 12	N/A
R35	R35	35 G protein-coupled receptor;G protein-coupled receptor R35;RNA fingerprint protein 35	N/A
RAG1	RAG1;RAG-1	recombination activating protein 1;recombination-activating protein 1	N/A
RAG2	RAG2;RAG-2	recombination activating protein 2;recombination-activating protein 2	N/A
REV3L	REV3L	polymerase zeta catalytic subunit;REV3-like	N/A
RHO	RHO	rhodopsin	N/A
SLC30A1	SLC30A1	solute carrier family 30 member 1	N/A
SLC8A1	SLC8A1	solute carrier family 8 member 1	N/A
SLC8A3	SLC8A3	solute carrier family 8 member 3	N/A
SNCAIP	SNCAIP;SINCAIP	synuclein alpha interacting protein;synuclein alpha-interacting protein	N/A
SOCS5	SOCS5	supressor of cytokine signaling 5	N/A
TRAF6	TRAF6	TNF receptor-associated factor 6	N/A
UBN1	UBN1	ubinuclein 1	N/A
VCPIP	VCPIP;VCPIP1	valosin-containing protein;p97/p47 complete interacting protein 1	N/A
ZEB2	ZEB2	zinc finger homeobox protein	N/A
ZFP36L1	ZFP36L1	zinc finger protein 36;protein 36 C3H type-like 1	N/A
MTDNA_12S	12S	12S ribosomal RNA;12S rRNA;small subunit ribosomal;mitochondrion complete genome;mitochondrial DNA complete genome;mitochondrion partial genome	pseudogene
MTDNA_16S	16S	16S ribosomal RNA;16srRNA;large subunit ribosomal;mitochondrion complete genome;mitochondrial DNA complete genome;mitochondrion partial genome	pseudogene
MTDNA_CO1	CO1;COX1;COI	cytochrome oxidase subunit 1;oxidase subunit I;oxidase subunit 1;mitochondrion complete genome;mitochondrial DNA complete genome;mitochondrion partial genome	pseudogene
MTDNA_CYTB	CYTB;CYT-B	cytochrome b;mitochondrion complete genome;mitochondrial DNA complete genome;mitochondrion partial genome	pseudogene
MTDNA_ND1	ND1	dehydrogenase subunit 1;mitochondrion complete genome;mitochondrial DNA complete genome;mitochondrion partial genome	pseudogene
MTDNA_ND2	ND2	dehydrogenase subunit 2;mitochondrion complete genome;mitochondrial DNA complete genome;mitochondrion partial genome	pseudogene
MTDNA_ND4	ND4	dehydrogenase subunit 4;mitochondrion complete genome;mitochondrial DNA complete genome;mitochondrion partial genome	pseudogene